...................++++.................
.....++++.....................+++++.....
............++++........................
.......................+++........++++..
............................++++........
....++++++.......++++++.................
...+....................................
++++++++++++++++++++++++++++++++++++++++