++++++++++++++++++++++++++++++++++++++++++
+........................................+
+........................................+
+....++++................................+
+....................++++.......+++++....+
+........................................+
+..........................+++........++++
+........................................+
+........................................+
+.............................++++.......+
+.....+++++++.....+++++++................+
+........................................+
++++++++++++++++++++++++++++++++++++++++++
++++++++++++++++++++++++++++++++++++++++++