11111111111111111111
11111111111111111111
00111111111111111111
00100000000000000111
00101010100101010111
00100000000000000111
00101000100100010111
00100000000000000111
00101010100101010111
00100000000000000111
00100000000000000111
00101010100101010111
00100000000000000111
00101000100100010111
00100000000000000111
00101010100101010111
00100000000000000111
00111111111111111111
11111111111111111111
11111111111111111111
