2
+.
+++++++++++++++++++++++++++++++++++++++++++++++++++++++++++++++++++++++++++++++++++++
+...................................................................................+
+...................................................................................+
+....++++......................................++++.................................+
+....................++++.......+++++..........................++++.......+++++.....+
++++................................................................................+
+..........................+++........+++............................+++........+++++
+...................................................................................+
+...................................................................................+
+.............................++++......................................++++........+
+.....+++++++.....+++++++.......................+++++++.....+++++++.................+
+...................................................................................+