...................++++.................
.....++++.....................+++++.....
............++++........................
.......................+++........++++..
............................++++........
....++++++.......++++++.................
........................................
++++++++++++++++++++++++++++++++++++++++