11111111111111111111
11111111111111111111
11000000000000000011
11000011011011000011
11000001011010000011
11000000000000000011
11010000011000001011
11011000000000011011
11000000011000000011
11011010111101011011
11011010111101011011
11000000011000000011
11011000000000011011
11010000011000001011
11000000000000000011
11000001011010000011
11000011011011000011
11000000000000000011
11111111111111111111
11111111111111111111